00222201002000
00011001220200
00010010020102
12110022011001
10221021010210
10201020010001
00210102201020
01220011020102
10020102010201
01110201120211
01220112201121
01221022001200
00220001122100
00011210002100