00111000011100
01210222201210
11102000020111
10201111110201
12001111110021
12010111101021
12001111110021
12010111101021
11201111110211
11121111112111
11102111120111
11000222200011
02011100111020
00111000011100