00000000000000
01111100111110
01202100120210
01111100111110
01202100120210
01111100111110
00000012000000
00000021000000
01111100111110
01202100120210
01111100111110
01202100120210
01111100111110
00000000000000